



      NO ./textures/texture1.xpm
SO ./textures/texture2.xpm
WE ./textures/texture3.xpm
EA ./textures/texture4.xpm

F 110,61,52
C 99,52,71

111111
10W001
100001
100001111111
100001100001
100001100001
100001100111
100001100111
100001100111
100001100111
100001100111
100001100111
100001100111
100001100111
100001100111
100001100111
100001100111
100001100111
100001100111
100001100111
100001100111
100001100111
100001100111
100001100111
100001100111
100001100111
100001100111
100001100111
100001100111
100001100111
100001100111
100001100111
100001100111
111111111111