



      NO ./textures/texture1.xpm
SO ./textures/texture2.xpm
WE ./textures/texture3.xpm
EA ./textures/texture4.xpm

F 110,61,52
C 99,52,71

111111111111111111111111111111                                
100000011000N00000000111111111
101100000100000010000111
1001000100000000000011111111
111111111000000001110000000011
100000000011000001110111111111
111101111111110111000000100011
111101111111110111010100100011
110000001101010111000000100011
100000000000000011000000100011
100000000000000110101001000011
110000011101010111110111100011
111101111111010111011110100011
111111111111111111111111111111