



      NO ./textures/texture1
SO ./textures/texture2
WE ./textures/texture3
EA ./textures/texture4

F 220,100,10
C 225,30,0

11111111111111111111111111111
100000011000N0000000011111111
10110000010000001000011111111
10010001000000000000011111111
11111111100000000111000000001
10000000001100000111011111111
11110111111111011100000010001
11110111111111011101010010001
11000000110101011100000010001
10000000000000001100000010001
10000000000000011010100100001
11000001110101011111011110001
11110111111101011101111010001
11111111111111111111111111111