
NO ./textures/texture1.xpm
F 220,100,0
SO ./textures/texture2.xpm
WE ./textures/texture3.xpm
EA ./textures/texture4.xpm
C 225,30,05


       
          
          


11111111111111111111111111111111111
         11111111111110000000000001  1111 1111111111          1
         1011000001110000000000001       111111               1
         1001000000000000000000001            11          111111
1        11011111111111111111111111111111111111111111111111111            1
111111111111000001110111111111111    
11110111111111011100000010001
11110111111111011101010010001
11000000110101011100000010001
1000000N00000000110000001000111111111111
10000000000000011010100100011111
111100000111010111111101111001111
1111101111110101 101111010001
1111111111111111 111111111111