
NO ./textures/texture1.xpm
SO ./textures/texture2.xpm
WE ./textures/texture3.xpm
EA ./textures/texture4.xpm      

C 0,9,055
F 15,100,05


       
          
          


1111111111111111111111111111
1000001000010001111101110001
0111111100000000000000000001
111111100000000000000000001
1111111000000000N00000000001
111111100000000000000000001
111111100000000000000000001
111111100000000000000000001
1111111111111111111111111111