


      NO ./textures/texture1
SO ./textures/texture2
WE ./textures/texture3
EA ./textures/texture4

F 220,100,10
C 225,30,0

11111111111111111111111111111
10000000000000000000000000001
10000000000000000000000000001
10000000000000000000000000001
1000000000S000000000000000001
10000000000000000000000000001
10000000000000000000000000001
10000000000000000000000000001
10000000000000000000000000001
10000000000000000000000000001
10000000000000000000000000001
11111111111111111111111111111